It is another hot summer day, roughly two weeks since the (virtual) end of human kind. You have made your way onto the roof of the building where you work, on lower Manhattan.

More recently, you climbed up on to the ledge of the building, your feet now dangling over the edge, two hundred and twenty feet above ground.

You are trying to work up the courage to jump.

Rooftops
An Interactive Fiction by Jonas Minnberg
Release 1 / Serial number 140823 / Inform 7 build 6L02 (I6/v6.33 lib 6/12N) SD

On the ledge
You are sitting on a ledge a couple of hundred feet above the Manhattan streets.

>look
On the ledge
You are sitting on a ledge a couple of hundred feet above the Manhattan streets.

I beg your pardon?

I beg your pardon?

>jump
You inch forward slightly, feeling the pull of the abyss below you but... you are not quite ready yet.

Loud moaning as wells as metallic thumbs can be heard from behind the metal door leading down to the stair well.

>d
Even if plunging hundreds of feet to your death is not appealing, what lies that way is even worse.

The thumbs are getting louder. The door is visibly starting to give. It is not long now.

>back
That's not a verb I recognise.

>look
On the ledge
You are sitting on a ledge a couple of hundred feet above the Manhattan streets.

Your contemplating is suddenly interrupted by the sharp sounds of small arms fire. From behind the door. More gun fire, the muffled sounds of screams. Then quiet...

* * *

It is another hot summer day, roughly two weeks since the (virtual) end of human kind. You have made your way onto the roof of the building where you work, on lower Manhattan.

More recently, you climbed up on to the ledge of the building, your feet now dangling over the edge, two hundred and twenty feet above ground.

You are trying to work up the courage to jump.

Rooftops
An Interactive Fiction by Jonas Minnberg
Release 1 / Serial number 140823 / Inform 7 build 6L02 (I6/v6.33 lib 6/12N) SD

On the ledge
You are sitting on a ledge a couple of hundred feet above the Manhattan streets.

>jump
You inch forward slightly, feeling the pull of the abyss below you but... you are not quite ready yet.

Loud moaning as wells as metallic thumbs can be heard from behind the metal door leading down to the stair well.

>d
Even if plunging hundreds of feet to your death is not appealing, what lies that way is even worse.

Loud moaning as wells as metallic thumbs can be heard from behind the metal door leading down to the stair well.

>z
Time passes.

The thumbs are getting louder. The door is visibly starting to give. It is not long now.

>z
Time passes.

Your contemplating is suddenly interrupted by the sharp sounds of small arms fire. From behind the door. More gun fire, the muffled sounds of screams. Then quiet...

* * *

>jump
You inch forward slightly, feeling the pull of the abyss below you but... you are not quite ready yet.

Loud moaning as wells as metallic thumbs can be heard from behind the metal door leading down to the stair well.

>down
Even if plunging hundreds of feet to your death is not appealing, what lies that way is even worse.

Wait for it...

Loud moaning as wells as metallic thumbs can be heard from behind the metal door leading down to the stair well.

>k
That's not a verb I recognise.

>sas
That's not a verb I recognise.

>look
On the ledge
You are sitting on a ledge a couple of hundred feet above the Manhattan streets.

The thumbs are getting louder. The door is visibly starting to give. It is not long now.

* * *

>jump
You inch forward slightly, feeling the pull of the abyss below you but... you are not quite ready yet.

Loud moaning as wells as metallic thumbs can be heard from behind the metal door leading down to the stair well.

>jump
You inch forward slightly, feeling the pull of the abyss below you but... you are not quite ready yet.

The thumbs are getting louder. The door is visibly starting to give. It is not long now.

>jump
You think you are finally ready... you close your eyes and inch your way slowly over the edge...

Your contemplating is suddenly interrupted by the sharp sounds of small arms fire. From behind the door. More gun fire, the muffled sounds of screams. Then quiet...

>d
A rooftop, somewhere on Manhattan
You can see Door to stairwell and Edward here.

>s
You can't go that way.

"Hey, are you going to open this door or what?"

>up
On the ledge
You are sitting on a ledge a couple of hundred feet above the Manhattan streets.

"Hey, are you going to open this door or what?"

>d
A rooftop, somewhere on Manhattan
You can see Door to stairwell and Edward here.

"Hey, are you going to open this door or what?"

>u
On the ledge
You are sitting on a ledge a couple of hundred feet above the Manhattan streets.

"Hey, are you going to open this door or what?"

>d
A rooftop, somewhere on Manhattan
You can see Door to stairwell and Edward here.

"Hey, are you going to open this door or what?"

>in
(first opening Door to stairwell)

Top of stairwell
You can see Door to stairwell here.

"Hey, are you going to open this door or what?"

>enter door
A rooftop, somewhere on Manhattan
You can see Door to stairwell and Edward here.

"Hey, are you going to open this door or what?"

* * *

It is another hot summer day, roughly two weeks since the (virtual) end of human kind. You have made your way onto the roof of the building where you work, on lower Manhattan.

More recently, you climbed up on to the ledge of the building, your feet now dangling over the edge, two hundred and twenty feet above ground.

You are trying to work up the courage to jump.

Rooftops
An Interactive Fiction by Jonas Minnberg
Release 1 / Serial number 140823 / Inform 7 build 6L02 (I6/v6.33 lib 6/12N) SD

On the ledge
You are sitting on a ledge a couple of hundred feet above the Manhattan streets.

>z
Time passes.

Loud moaning as wells as metallic thumps can be heard from behind the metal door leading down to the stair well.

>z
Time passes.

The thumps are getting louder. The door is visibly starting to give. It is not long now.

>z
Time passes.

Your contemplating is suddenly interrupted by the sharp sounds of small arms fire. From behind the door. More gun fire, the muffled sounds of screams. Then quiet...

>z
Time passes.

>z
Time passes.

"Hey, are you going to open this door or what?"

>z
Time passes.

"Hey, are you going to open this door or what?"

* * *

>z
Time passes.

Your contemplating is suddenly interrupted by the sharp sounds of small arms fire. From behind the door. More gun fire, the muffled sounds of screams. Then quiet...

>d
Outside stairwell
An ordinary rooftop, surrounding a small Roof exit structure with an entrance to the stairwell.

You have wedged and old office chair is under the door handle, in a somewhat futile attempt to keep the ... creatures out.

>look
A rooftop, somewhere on Manhattan
You can see Stairwell door and a chair here.

>open door
You can't do that while it's blocked by the chair

>z
Time passes.

>open door
You can't do that while it's blocked by the chair

>push chair
You move the chair out of the way.

>open door
You open Stairwell door.

>in
Top of stairwell
You can see Stairwell door and Edward here.

>x chair
You can't see any such thing.

>out
A rooftop, somewhere on Manhattan
You can see Stairwell door and a chair here.

>x chair
An old office chair.

* * *

>d
Outside stairwell
An ordinary rooftop, surrounding a small Roof exit structure with an entrance to the stairwell.

You have wedged and old office chair is under the door handle, in a somewhat futile attempt to keep the ... creatures out.

>move chair
You move the office chair out of the way.

>in
(first opening the stairwell door)

top of stairwell
You can see Edward here.

>x edward
He looks like a business type — or rather looked. What once appears to have been an expensive suit now is torn and covered with blood and soot. His narrow face is pale, dirty and unshaven, but given the circumstances he looks reasonably sane. The gun you heard is held in what looks like a home made holster constructed from duct tape and some sort of plastic container.He has a rope slung over his shoulder.

>edward, give rope to me
"...what do you have in mind?"

Edward gives the rope to you.

>edward, give rope to you
There is no reply.

>edward, drop rope
"...what do you have in mind?"
Edward puts down the rope.

>x edward
He looks like a business type - or rather looked. What once appears to have been an expensive suit now is torn and covered with blood and soot. His narrow face is pale, dirty and unshaven, but given the circumstances he looks reasonably sane. The gun you heard is held in what looks like a home made holster constructed from duct tape and some sort of plastic container..

>get rope
Taken.

>out
Outside stairwell
An ordinary rooftop, surrounding a small Roof exit structure with an entrance to the stairwell.

You can see an office chair here.

>x chair
An old office chair.

>i
You are carrying:
  a rope (with both ends free)

>x chair
An old office chair.

>type rope to chair
That's not a verb I recognise.

>tie rope to chair
You loop the rope around the office chair and knot firmly.

>i
You are carrying:
  an rope (attached to the office chair)

>in
Top of stairwell
You can see Edward here.

>inv
You are carrying:
  an rope (attached to the office chair)

>x chair
You can't see any such thing.

>out
Outside stairwell
An ordinary rooftop, surrounding a small Roof exit structure with an entrance to the stairwell.

You can see an office chair here.

>i
You are carrying:
  an rope (attached to the office chair)

>x chair
An old office chair.

The office chair is currently attached to the rope.

>x handle
Looks solid enough.

>x door
(the stairwell door)
A metal door leading to the stairwell.

>l
Outside stairwell
An ordinary rooftop, surrounding a small Roof exit structure with an entrance to the stairwell.

You can see an office chair here.

>x door handle
Looks solid enough.

>tie rope to handle
You loop the rope around the door handle and knot firmly.

>x rope
The rope is tied to the office chair and the door handle.

>in
Top of stairwell
You can see Edward here.

>i
You are carrying:
  a rope (attached to the office chair and the door handle)

>edward, drop rope
"...what do you have in mind?"
Edward is unable to do that.

>ds
That's not a verb I recognise.

>edward, give tie to me
"...what do you have in mind?"

(first taking the Armani tie off)

>i
You are carrying:
  a rope (attached to the office chair and the door handle)

>edward give tie to me
That's not a verb I recognise.

>edward, give tie to me
"...what do you have in mind?"

>x tie
You see nothing special about the Armani tie.

>inv
You are carrying:
  a rope (attached to the office chair and the door handle)

>look
Top of stairwell
You can see Edward here.

>out
Outside stairwell
An ordinary rooftop, surrounding a small Roof exit structure with an entrance to the stairwell.

You can see an office chair here.

>x tie
You can't see any such thing.

>in
Top of stairwell
You can see Edward here.

>edward, give suit to me
"...what do you have in mind?"

(first taking the torn suit off)

>edward, give gun to me
"...what do you have in mind?"

>edward, give gun to me
"...what do you have in mind?"

>i
You are carrying:
  a rope (attached to the office chair and the door handle)

>rules
Rules tracing now switched on. Type "rules off" to switch it off again, or "rules all" to include even rules which do not apply.

>edward, give gun to me
[Rule "declare everything initially unmentioned rule" applies.]
[Rule "announce items from multiple object lists rule" applies.]
[Rule "set pronouns from items from multiple object lists rule" applies.]
[Rule "before stage rule" applies.]
[Rule "instead stage rule" applies.]
[Rule "Instead of asking edward to try giving something to the player" applies.]
"...what do you have in mind?"

[Rule "announce items from multiple object lists rule" applies.]
[Rule "set pronouns from items from multiple object lists rule" applies.]
[Rule "before stage rule" applies.]
[Rule "instead stage rule" applies.]
[Rule "investigate player's awareness before action rule" applies.]
[Rule "player aware of his own actions rule" applies.]
[Rule "player aware of actions by visible actors rule" applies.]
[Rule "check stage rule" applies.]
[Rule "can't give what you haven't got rule" applies.]
[Rule "can't give to yourself rule" applies.]
[Rule "can't give to a non-person rule" applies.]
[Rule "can't give clothes being worn rule" applies.]
[Rule "block giving rule" applies.]
[Rule "A first turn sequence rule" applies.]
[Rule "every turn stage rule" applies.]
[Rule "A last turn sequence rule" applies.]
[Rule "notify score changes rule" applies.]

>actions
[Rule "declare everything initially unmentioned rule" applies.]
Actions listing on.

>edward, give gun to me
[Rule "declare everything initially unmentioned rule" applies.]
[asking Edward to try giving the gun to yourself]
[Rule "announce items from multiple object lists rule" applies.]
[Rule "set pronouns from items from multiple object lists rule" applies.]
[Rule "before stage rule" applies.]
[Rule "instead stage rule" applies.]
[Rule "Instead of asking edward to try giving something to the player" applies.]
"...what do you have in mind?"

[(1) Edward giving the gun to yourself]
[Rule "announce items from multiple object lists rule" applies.]
[Rule "set pronouns from items from multiple object lists rule" applies.]
[Rule "before stage rule" applies.]
[Rule "instead stage rule" applies.]
[Rule "investigate player's awareness before action rule" applies.]
[Rule "player aware of his own actions rule" applies.]
[Rule "player aware of actions by visible actors rule" applies.]
[Rule "check stage rule" applies.]
[Rule "can't give what you haven't got rule" applies.]
[Rule "can't give to yourself rule" applies.]
[Rule "can't give to a non-person rule" applies.]
[Rule "can't give clothes being worn rule" applies.]
[Rule "block giving rule" applies.]
[(1) Edward giving the gun to yourself - failed the block giving rule]

[asking Edward to try giving the gun to yourself - failed the block giving rule]

[Rule "A first turn sequence rule" applies.]
[Rule "every turn stage rule" applies.]
[Rule "A last turn sequence rule" applies.]
[Rule "notify score changes rule" applies.]

* * *

>edward, give rope to me
"...what do you have in mind?"

Edward gives the rope to you.

>i
You are carrying:
  a rope (with both ends free)

>edward, give gun to me
Edward has better things to do.

>throw rope
What do you want to throw the rope towards?

>abstract
(the rope to the rope)
[Can't move rope: it would contain itself.]

>debug
That's not a verb I recognise.

>help debug
That's not a verb I recognise.

>debug door
That's not a verb I recognise.

>l
top of stairwell
You can see Edward here.

>get rope
You already have that.

>out
Outside stairwell
An ordinary rooftop, surrounding a small Roof exit structure with an entrance to the stairwell.

You can see an office chair here.

>tie rope to chair
You loop the rope around the office chair and knot firmly.

>up
You drag along behind you the office chair.

On the ledge
You are sitting on a ledge a couple of hundred feet above the Manhattan streets.

You can see an office chair here.

>x rope
The rope is tied to the office chair.

>x chair
An old office chair.

The office chair is currently attached to the rope.

>get rope
You already have that.

>untie rope
(from the office chair)

Untied.

>down
Outside stairwell
An ordinary rooftop, surrounding a small Roof exit structure with an entrance to the stairwell.

>untie rope
The rope is already entirely free.

>i
You are carrying:
  a rope (with both ends free)

>tie rope to door
(the stairwell door)
You loop the rope around the door handle and knot firmly.

>i
You are carrying:
  a rope (attached to the door handle)

>x door handle
Looks solid enough.

The door handle is currently attached to the rope.

>tie rope to chair
You can't see any such thing.

>x rope
The rope is tied to the door handle.

>throw chair north
You can't see any such thing.

>throw chair to north
You can't see any such thing.

>throw chair towards ledge
You can't see any such thing.

>throw chair towards door
You can't see any such thing.

>throw chair
You can't see any such thing.

>i
You are carrying:
  a rope (attached to the door handle)

>throw chair towards north
You can't see any such thing.

>throw chair towards north
You can't see any such thing.

>throw chair towards ledge
You can't see any such thing.

>throw chair towards stairwell
You can't see any such thing.

>throw chair towards outside stairwell
You can't see any such thing.

>l
Outside stairwell
An ordinary rooftop, surrounding a small Roof exit structure with an entrance to the stairwell.

>out
But you aren't in anything at the moment.

>i
You are carrying:
  a rope (attached to the door handle)

>in
top of stairwell
You can see Edward here.

>out
Outside stairwell
An ordinary rooftop, surrounding a small Roof exit structure with an entrance to the stairwell.

>l
Outside stairwell
An ordinary rooftop, surrounding a small Roof exit structure with an entrance to the stairwell.

>x chair
You can't see any such thing.

>in
top of stairwell
You can see Edward here.

>x chair
You can't see any such thing.

>out
Outside stairwell
An ordinary rooftop, surrounding a small Roof exit structure with an entrance to the stairwell.

* * *

>l
Outside stairwell
An ordinary rooftop, surrounding a small Roof exit structure with an entrance to the stairwell.

>up
On the ledge
You are sitting on a ledge a couple of hundred feet above the Manhattan streets.

You can see an office chair here.

* * *

>move chair
You move the office chair out of the way.

>open door
(the stairwell door)
You open the stairwell door.

>in
top of stairwell
You can see Edward here.

>z
Time passes.

>z
Time passes.

>out
Outside stairwell
An ordinary rooftop, surrounding a small Roof exit structure with an entrance to the stairwell.

You can see an office chair here.

>tie rope to chair
You can't see any such thing.

>in
top of stairwell
You can see Edward here.

>get rope
Fatal error: Stack overflow

[ The game has finished ]

* * *

It is another hot summer day, roughly two weeks since the (virtual) end of human kind. You have made your way onto the roof of the building where you work, on lower Manhattan.

More recently, you climbed up on to the ledge of the building, your feet now dangling over the edge, two hundred and twenty feet above ground.

You are trying to work up the courage to jump.

Rooftops
An Interactive Fiction by Jonas Minnberg
Release 1 / Serial number 140823 / Inform 7 build 6L02 (I6/v6.33 lib 6/12N) SD

On the ledge
You are sitting on a ledge a couple of hundred feet above the Manhattan streets.

>x street
You can't see any such thing.

>x streets
Far below you you can see wrecked cars, dead drivers and and pedestrians. And yes, for being dead some of them are awfully... mobile.

Loud moaning as wells as metallic thumps can be heard from behind the metal door leading down to the stair well.

>x ledge
You see nothing special about the ledge.

The thumps are getting louder. The door is visibly starting to give. It is not long now.

>jump
You think you are finally ready... you close your eyes and inch your way slowly over the edge...

Your contemplating is suddenly interrupted by the sharp sounds of small arms fire. From behind the door. More gun fire, the muffled sounds of screams. Then quiet...

>jump
For the moment at least, you have no direct urge to end things.

>down
A rooftop, somewhere on Manhattan
An ordinary rooftop, surrounding a small Roof exit structure with an entrance to the stairwell.

You have wedged and old office chair is under the door handle, in a somewhat futile attempt to keep the ... creatures out.

You can also see a stairwell door here.

>open door
You can't do that while it's blocked by the office chair.

>x chair
An old office chair.

>look
A rooftop, somewhere on Manhattan
An ordinary rooftop, surrounding a small Roof exit structure with an entrance to the stairwell.

You have wedged and old office chair is under the door handle, in a somewhat futile attempt to keep the ... creatures out.

You can also see a stairwell door here.

>move chair
You move the office chair out of the way.

>look
A rooftop, somewhere on Manhattan
An ordinary rooftop, surrounding a small Roof exit structure with an entrance to the stairwell.

You can see a stairwell door and an office chair here.

>look down
You see nothing unexpected in that direction.

>x down
You see nothing unexpected in that direction.

>in
(first opening the stairwell door)

Top of stairwell
You can see a stairwell door and Edward here.

>up
You can't go that way.

>out
A rooftop, somewhere on Manhattan
An ordinary rooftop, surrounding a small Roof exit structure with an entrance to the stairwell.

You can see a stairwell door and an office chair here.

>up
On the ledge
You are sitting on a ledge a couple of hundred feet above the Manhattan streets.

>x streets
Far below you you can see wrecked cars, dead drivers and and pedestrians. And yes, for being dead some of them are awfully... mobile.

>x drivers
You see nothing special about dead drivers and.

>x pedestrians
Yes, even though you still have a hard time believing it ... the dead are walking.

>d
A rooftop, somewhere on Manhattan
An ordinary rooftop, surrounding a small Roof exit structure with an entrance to the stairwell.

You can see a stairwell door and an office chair here.

>in
Top of stairwell
You can see a stairwell door and Edward here.

>x edward
You see nothing special about Edward.

>x rope
You see nothing special about the rope.

>x ads
You can't see any such thing.

>edward, give rope
(to Edward)
Edward has better things to do.

* * *

It is another hot summer day, roughly two weeks since the (virtual) end of human kind. You have made your way onto the roof of the building where you work, on lower Manhattan.

More recently, you climbed up on to the ledge of the building, your feet now dangling over the edge, two hundred and twenty feet above ground.

You are trying to work up the courage to jump.

Rooftops
An Interactive Fiction by Jonas Minnberg
Release 1 / Serial number 140823 / Inform 7 build 6L02 (I6/v6.33 lib 6/12N) SD

On the ledge
You are sitting on a ledge a couple of hundred feet above the Manhattan streets.

>x rooftop
You can't see any such thing.

>x structure
A small brick structure with a gray, metal door on one side, leading inside to the stairwell of the building.

Loud moaning as wells as metallic thumps can be heard from behind the metal door leading down to the stair well.

>x door
You can't see any such thing.

>z
Time passes.

The thumps are getting louder. The door is visibly starting to give. It is not long now.

* * *

>d
Outside stairwell
An ordinary rooftop, surrounding a small Roof exit structure with an entrance to the stairwell.

You have wedged and old office chair is under the door handle, in a somewhat futile attempt to keep the ... creatures out.

>up
On the ledge
You are sitting on a ledge a couple of hundred feet above the Manhattan streets.

>down
Outside stairwell
An ordinary rooftop, surrounding a small Roof exit structure with an entrance to the stairwell.

You have wedged and old office chair is under the door handle, in a somewhat futile attempt to keep the ... creatures out.

>x door
You see nothing special about the stairwell door.

>open door
You can't do that while it's blocked by the office chair.

>move chair
You move the office chair out of the way.

>open door
You open the stairwell door.

>in
Top of stairwell
You can see Edward here.

>l
Top of stairwell
You can see Edward here.

>x edward
He looks like a business type - or rather looked. What once appears to have been an expensive suit now is torn and covered with blood and soot. His narrow face is pale, dirty and unshaven, but given the circumstances he looks reasonably sane. The gun you heard is held in what looks like a home made holster constructed from duct tape and some sort of plastic container.He has a rope slung over his shoulder

>edward, give gun
There is no reply.

>edward, give rope
(to Edward)
Edward has better things to do.

>edward, give rope to me
"...what do you have in mind?"

>rules
Rules tracing now switched on. Type "rules off" to switch it off again, or "rules all" to include even rules which do not apply.

>edward, give rope to me
[Rule "declare everything initially unmentioned rule" applies.]
[Rule "announce items from multiple object lists rule" applies.]
[Rule "set pronouns from items from multiple object lists rule" applies.]
[Rule "before stage rule" applies.]
[Rule "instead stage rule" applies.]
[Rule "Instead of asking edward to try giving the rope to the player" applies.]
"...what do you have in mind?"

[Rule "announce items from multiple object lists rule" applies.]
[Rule "set pronouns from items from multiple object lists rule" applies.]
[Rule "before stage rule" applies.]
[Rule "instead stage rule" applies.]
[Rule "investigate player's awareness before action rule" applies.]
[Rule "player aware of his own actions rule" applies.]
[Rule "player aware of actions by visible actors rule" applies.]
[Rule "check stage rule" applies.]
[Rule "can't give what you haven't got rule" applies.]
[Rule "can't give to yourself rule" applies.]
[Rule "can't give to a non-person rule" applies.]
[Rule "can't give clothes being worn rule" applies.]
[Rule "block giving rule" applies.]
[Rule "A first turn sequence rule" applies.]
[Rule "every turn stage rule" applies.]
[Rule "A last turn sequence rule" applies.]
[Rule "notify score changes rule" applies.]

>edward, give rope to edward
[Rule "declare everything initially unmentioned rule" applies.]
[Rule "announce items from multiple object lists rule" applies.]
[Rule "set pronouns from items from multiple object lists rule" applies.]
[Rule "before stage rule" applies.]
[Rule "instead stage rule" applies.]
Edward has better things to do.

[Rule "A first turn sequence rule" applies.]
[Rule "every turn stage rule" applies.]
[Rule "A last turn sequence rule" applies.]
[Rule "notify score changes rule" applies.]

>edward, drop rope
[Rule "declare everything initially unmentioned rule" applies.]
[Rule "announce items from multiple object lists rule" applies.]
[Rule "set pronouns from items from multiple object lists rule" applies.]
[Rule "before stage rule" applies.]
[Rule "instead stage rule" applies.]
Edward has better things to do.

[Rule "A first turn sequence rule" applies.]
[Rule "every turn stage rule" applies.]
[Rule "A last turn sequence rule" applies.]
[Rule "notify score changes rule" applies.]

>i
[Rule "declare everything initially unmentioned rule" applies.]
[Rule "announce items from multiple object lists rule" applies.]
[Rule "set pronouns from items from multiple object lists rule" applies.]
[Rule "before stage rule" applies.]
[Rule "instead stage rule" applies.]
[Rule "investigate player's awareness before action rule" applies.]
[Rule "player aware of his own actions rule" applies.]
[Rule "check stage rule" applies.]
[Rule "carry out stage rule" applies.]
[Rule "print empty inventory rule" applies.]
You are carrying nothing.
[Rule "after stage rule" applies.]
[Rule "investigate player's awareness after action rule" applies.]
[Rule "report stage rule" applies.]

[Rule "report other people taking inventory rule" applies.]
[Rule "last specific action-processing rule" applies.]
[Rule "A first turn sequence rule" applies.]
[Rule "every turn stage rule" applies.]
[Rule "A last turn sequence rule" applies.]
[Rule "notify score changes rule" applies.]

>get chair
You can't see any such thing.

* * *

>get chair
[Rule "declare everything initially unmentioned rule" applies.]
[Rule "announce items from multiple object lists rule" applies.]
[Rule "set pronouns from items from multiple object lists rule" applies.]
[Rule "before stage rule" applies.]
[Rule "instead stage rule" applies.]
[Rule "investigate player's awareness before action rule" applies.]
[Rule "player aware of his own actions rule" applies.]
[Rule "check stage rule" applies.]
[Rule "can't take yourself rule" applies.]
[Rule "can't take other people rule" applies.]
[Rule "can't take component parts rule" applies.]
[Rule "can't take people's possessions rule" applies.]
[Rule "can't take items out of play rule" applies.]
[Rule "can't take what you're inside rule" applies.]
[Rule "can't take what's already taken rule" applies.]
[Rule "can't take scenery rule" applies.]
[Rule "can only take things rule" applies.]
[Rule "can't take what's fixed in place rule" applies.]
[Rule "use player's holdall to avoid exceeding carrying capacity rule" applies.]
[Rule "can't exceed carrying capacity rule" applies.]
[Rule "carry out stage rule" applies.]
[Rule "standard taking rule" applies.]
[Rule "after stage rule" applies.]
[Rule "investigate player's awareness after action rule" applies.]
[Rule "report stage rule" applies.]
[Rule "standard report taking rule" applies.]
Taken.
[Rule "last specific action-processing rule" applies.]

[Rule "A first turn sequence rule" applies.]
[Rule "every turn stage rule" applies.]
[Rule "A last turn sequence rule" applies.]
[Rule "notify score changes rule" applies.]

* * *

>give chair to edward
[Rule "declare everything initially unmentioned rule" applies.]
[Rule "announce items from multiple object lists rule" applies.]
[Rule "set pronouns from items from multiple object lists rule" applies.]
[Rule "before stage rule" applies.]
[Rule "instead stage rule" applies.]
[Rule "investigate player's awareness before action rule" applies.]
[Rule "player aware of his own actions rule" applies.]
[Rule "check stage rule" applies.]
[Rule "can't give what you haven't got rule" applies.]
[Rule "can't give to yourself rule" applies.]
[Rule "can't give to a non-person rule" applies.]
[Rule "can't give clothes being worn rule" applies.]
[Rule "block giving rule" applies.]
Edward doesn't seem interested.

[Rule "A first turn sequence rule" applies.]
[Rule "every turn stage rule" applies.]
[Rule "A last turn sequence rule" applies.]
[Rule "notify score changes rule" applies.]

>edward, give rope to me
[Rule "declare everything initially unmentioned rule" applies.]
[Rule "announce items from multiple object lists rule" applies.]
[Rule "set pronouns from items from multiple object lists rule" applies.]
[Rule "before stage rule" applies.]
[Rule "instead stage rule" applies.]
[Rule "Instead of asking edward to try giving the rope to the player" applies.]
"...what do you have in mind?"

[Rule "announce items from multiple object lists rule" applies.]
[Rule "set pronouns from items from multiple object lists rule" applies.]
[Rule "before stage rule" applies.]
[Rule "instead stage rule" applies.]
[Rule "investigate player's awareness before action rule" applies.]
[Rule "player aware of his own actions rule" applies.]
[Rule "player aware of actions by visible actors rule" applies.]
[Rule "check stage rule" applies.]
[Rule "can't give what you haven't got rule" applies.]
[Rule "can't give to yourself rule" applies.]
[Rule "can't give to a non-person rule" applies.]
[Rule "can't give clothes being worn rule" applies.]
[Rule "block giving rule" applies.]
[Rule "A first turn sequence rule" applies.]
[Rule "every turn stage rule" applies.]
[Rule "A last turn sequence rule" applies.]
[Rule "notify score changes rule" applies.]

>rules off
[Rule "declare everything initially unmentioned rule" applies.]
Rules tracing now switched off. Type "rules" to switch it on again.

>edward, give rope to me
"...what do you have in mind?"

I beg your pardon?

>edward, give rope to me
"...what do you have in mind?"

>i
You are carrying:
  an office chair

* * *

It is another hot summer day, roughly two weeks since the (virtual) end of human kind. You have made your way onto the roof of the building where you work, on lower Manhattan.

More recently, you climbed up on to the ledge of the building, your feet now dangling over the edge, two hundred and twenty feet above ground.

You are trying to work up the courage to jump.

Rooftops
An Interactive Fiction by Jonas Minnberg
Release 1 / Serial number 140823 / Inform 7 build 6L02 (I6/v6.33 lib 6/12N) SD

On the ledge
You are sitting on a ledge a couple of hundred feet above the Manhattan streets.

>get rope
You can't see any such thing.

>z
Time passes.

Loud moaning as wells as metallic thumps can be heard from behind the metal door leading down to the stair well.

* * *

>x edward
He looks like a business type — or rather looked. What once appears to have been an expensive suit now is torn and covered with blood and soot. His narrow face is pale, dirty and unshaven, but given the circumstances he looks reasonably sane. The gun you heard is held in what looks like a home made holster constructed from duct tape and some sort of plastic container.He has a rope slung over his shoulder.

>edward, give me rope
"...what do you have in mind?"

Edward gives the rope to you.

>i
You are carrying:
  a rope (with both ends free)

>out
Outside stairwell
An ordinary rooftop, surrounding a small Roof exit structure with an entrance to the stairwell.

You can see an office chair here.

>tie rope to handle
You loop the rope around the door handle and knot firmly.

>tie rope to chair
You loop the rope around the office chair and knot firmly.

>get rope
You already have that.

>drop rope
Dropped.

>i
You are carrying nothing.

>l
Outside stairwell
An ordinary rooftop, surrounding a small Roof exit structure with an entrance to the stairwell.

There is a rope here, tied to the office chair and the door handle.

>get rope
Taken.

>in
You drag along behind you the office chair.

top of stairwell
You can see an office chair and Edward here.

>i
You are carrying:
  a rope (attached to the office chair and the door handle)

>out
You drag along behind you the office chair.

Outside stairwell
An ordinary rooftop, surrounding a small Roof exit structure with an entrance to the stairwell.

You can see an office chair here.

>i
You are carrying:
  a rope (attached to the office chair and the door handle)

>look
Outside stairwell
An ordinary rooftop, surrounding a small Roof exit structure with an entrance to the stairwell.

You can see an office chair here.

>get chair
Taken.

>x chair
An old office chair.

The office chair is currently attached to the rope and the door handle.

>throw chair
What do you want to throw the office chair towards?

>throw chair south
I didn't understand that sentence.

>throw chair towards south
You must name something more substantial.